NO ./assets/textures/bluestone.xpm
SO ./assets/textures/redbrick.xpm
WE ./assets/textures/wood.xpm
EA ./assets/textures/greystone.xpm

C 56,56,56
F 112,112,112

111111111111111111111111111111111111
100000000000000000000000000000000001
100000000000000000000000000000000001
100000000000000000000000000000000001
100000111110000000000101010000000001
10000010S010000000000000000000000001
100000100010000000000100010000000001
100000100010000000000000000000000001
100000110110000000000101010000000001
100000000000000000000000000000000001
100000000000000000000000000000000001
100000000000000000000000000000000001
100000000000000000000000000000000001
100000000000000000000000000001111111
100000000000000000000000000001
100000000000000000000000000001
111111111000000000000000000001
110100001000000000000000000001
110000101000000000000000000001
110100001000000000000000000001
110111111000000000000000000001
110000000000000000000000000001
111111111000000000000000000001
111111111111111111111111111111