NO ./assets/textures/gray.xpm
SO ./assets/textures/red.xpm
WE ./assets/textures/green.xpm
EA ./assets/textures/blue.xpm

C 28,28,28
F 28,28,28

11111
10001
10N01
10001
11111