NO ./assets/textures/gray.xpm
SO ./assets/textures/red.xpm
WE ./assets/textures/green.xpm
EA ./assets/textures/blue.xpm

F 220,100,0
C 225,30,0

0111
1N01
1111